1 17 17
#################
#p     s* *    *#
# # # #*# # #*# #
#  x*     b**  *#
# # # # # #*# # #
#f           ** #
# # # # # # # # #
#*  *  1   *  * #
# # # # #*# # # #
#*    **  *     #
# #*# # # # # # #
#           *   #
# # # # # # # # #
#*   *  2  *    #
# # # # # # # # #
#               #
#################