3 17 17
#################
#p *  *  *  *  *#
# # # # # # # # #
#  *  *  *  *  *#
# # # # #*# # # #
#  *  *  *  *  *#
# # # # # # # # #
#  *         *  #
# # # # # # # # #
#  *  *  *  *  *#
# # # # #*# # # #
#  *  *  *  *  *#
# # # # # # # # #
#  *  *  *  *  *#
# # # # # # # # #
# 1  *  x*  *  1#
#################