5 17 17
#################
#p *  * 1  *  * #
# # # # # # # # #
#  *  *  *  * x*#
# # # # #*# # # #
#  *  * 1  *  * #
# # # # # # # # #
#  *         *  #
# # # # # # # # #
#  *  * 1  *  * #
# # # # #*# # # #
#  *  *  *  *  *#
# # # # # # # # #
#  *  *  *  *  *#
# # # # # # # # #
# 1  *  *  *  1 #
#################
