4 17 17
#################
#p *  *  *b *  *#
# # # # # # # # #
#  *  *  *  *  *#
# # # # #*# # # #
#  *  * 1  *  * #
# # # # # # # # #
#  * 2   s   *  #
# # # # # # # # #
# f*  * 2  *  * #
# # # # #*# # # #
#  *  *  *  *  *#
# # # # # # # # #
#  *  *  *  x*  #
# # # # # # # # #
# 1  *  *  *  1 #
#################