5 17 17
#################
#p *  * 1  *  * #
# # # # # # # # #
#  *  *  *  * x*#
# # # # #*# # # #
#  *  * 2  *  * #
# # # # # # # # #
#  *  2    b *  #
# # # # # # # # #
#  *f * 1  *  * #
# # # # #*# # # #
#  *  *  *  *  *#
# # # # # # # # #
# b*  *  *  *  *#
# # # # # # # # #
# 1  *  *  *  1 #
#################
