3 17 17
#################
#p *  *  *  * f*#
# # # # # # # # #
#  *  *  *  *  *#
# # # # #*# # # #
#  *  * s*  *  *#
# # # # # # # # #
#  *    2    *  #
# # # # # # # # #
# b*  *  *  *  *#
# # # # #*# # # #
#  *  *  * 2*  *#
# # # # # # # # #
#  *  *  *  *  *#
# # # # # # # # #
# 1  *  x*  *  1#
#################