2 17 17
#################
#p  *  *  *  *  #
# # # # # # # # #
#    *    *    *#
# # # # #*# # # #
#  *  *  *  x*  #
# # # # # # # # #
#  *    1    *  #
# # # # # # # # #
#  *  *  *  *   #
# # # # #*# # # #
#    *    *    *#
# # # # # # # # #
#  *  *  *  *   #
# # # # # # # # #
#  *  *  *  * 1 #
#################




